History of the conflict between religion and science	by John William Draper
The answer of Ernst Haeckel to the falsehoods of the Jesuits, Catholic and Protestant, from the German pamphlet "Sandalion," and "My church departure"	by Haeckel, Ernst
From Rome to Rationalism: or Why I Left the Church	by McCabe, Joseph
The Workshop and the World: What Ten Thinkers Can Teach Us About Science and Authority	by Crease, Robert P.
A history of the warfare of science with theology in Christendom, vol. 1	by White, Andrew Dickson
A history of the warfare of science with theology in Christendom, vol 2
Blind faith: the unholy alliance of religion and medicine	by Sloan, Richard P.
The Skeptics' Guide to the Universe: How to Know What's Really Real in a World Increasingly Full of Fake	by Steve Novella with Bob Novella, Cara Santa Maria, Jay Novella, and Evan Bernstein
Homeopathy Reconsidered — What Really Helps Patients (German title: Homöopathie neu gedacht — Was wirklich Patienten hilft)	by Grams, Natalie
Gesundheit — A Book not Without Side Effects (German title: Gesundheit — Ein Buch nicht ohne Nebenwirkungen)	by Grams, Natalie
The Big Picture On the Origins of Life, Meaning and the Universe Itself	by Carroll, Sean M.
Cosmic Trigger I: The Final Secret of the Illuminati	by Wilson, Robert A
White Nights, Black Paradise	by Hutchinson, Sikivu
The Outsider Test for Faith: How to know which Religion is True	by Loftus, John
The UFO Handbook	by Hendry, Allan
Disproving Christianity: Refuting the World's Most Followed Religion	by McAfee, David
Disproving Christianity and Other Secular Writings: Second Edition	by McAfee, David
Mom, Dad, I'm an Atheist: The Guide to Coming Out as a Non-believer	by McAfee, David
The Belief Book	by McAfee, David
Snarls From the Tea-Tree: Big Cat Folklore	by Waldron, David; Simon Townsend
Sounds Sciencey: A Comic Strip Collection About Science, Pseudoscience, and Geeky Relationships	by Sanders, Kyle (Creator), Wikey, Elisa (Illustrator)
Undue Influence: Cons, Scams and Mind Control	by O'Reilly, Patrick; Phyllis Rosen
Fairy Tales Fairly Told	by Mervine, Barbara "Kitty"
Women Without Superstition: "No Gods-No Masters"	by Gaylor, Annie Laurie (ed).
Beyond the Body: An Investigation of Out-of-the-Body Experiences	by Blackmore, Susan
God Sent Me: A Textbook Case on Evolution vs. Creation	by Selman, Jeffrey
Outlines of Pyrrhonism	by Empiricus, Sextus
The Art of Thinking Clearly	by Dobelli, Rolf
Thinking to Some Purpose	by Stebbing, Susan
The Comforts Of Unreason: A Study of the Motives Behind Irrational Thought	by Cranshaw-Williams, Rupert
Homeopathy: How It Really Works	by Shelton, Jay
The Healing Gods: Complementary and Alternative Medicine in Christian America	by Brown, Candy Gunther
The Fear Babe: Shattering Vani Hari's Glass House	by Draco, Marc; Kavin Senapathy; Mark Alsip
Vitamin Politics	by Fried, John J.
The Battle Over the Meaning of Everything: Evolution, Intelligent Design, and a School Board in Dover, PA	by Slack, Gordy
Nutrition Cultism Facts and Fictions	by Herbert, Victor
Examining Holistic Medicine	by Stalker, Douglas; Clark Glymour
Monkey Girl: Evolution, Education, Religion, and the Battle for America's Soul	by Humes, Edward
The Devil in Dover: An Insider's Story of Dogma V. Darwin in Small-town America	by Lebo, Lauri
Nature Cures: The History of Alternative Medicine in America	by Whorton, James E
Let Them Eat Precaution: How Politics is Undermining the Genetic Revolution in Agriculture	by Entine, Jon
Follies of the Wise: Dissenting Essays	by Crews, Frederick
Charlatan: America's Most Dangerous Huckster, the Man Who Pursued Him, and the Age of Flimflam	by Brock, Pope
Inside Chiropractic: A Patient's Guide (Consumer Health Library)	by Homola, Samuel; Stephen Barrett
Follies and Fallacies in Medicine	by Skrabanek, Petr; James McCormick
Popular Nutritional Practices: Sense and Nonsense	by Jack Yetiv
Christian Science	by Twain, Mark
Sapiens: A Brief History of Humankind	by Harari, Yuval Noah
Moral Tribes: Emotion, Reason, and the Gap Between Us and Them	by Greene, Joshua
How to be a Good Atheist	by Harding, Nick
God: A Psychological Assessment	by Bakker, Gary
"It's Not About the Sex" My Ass	by Hanks, Joanne
Weird Water & Fuzzy Logic	by Gardner, Martin
Victims of Memory: Sex Abuse Accusations and Shattered Lives	by Pendergrast, Mark; Melody Gavigan
Things I Think About – Volume 1	by Bowditch, Peter
Superstition: Belief in the Age of Science	by Park, Robert
The Sorcerer of Kings: The Case of Daniel Dunglas Home and William Crookes	by Stein, Gordon; James Randi
Smoke and Mirrors: The Devastating Effect of False Sexual Abuse Claims	by Campbell, Terence W.
Science Versus Religion	by Clements, Tad S.
Science and Religion: Are They Compatible?	by Kurtz, Paul; Barry Karr; Ranjit Sandhu
Remembering Satan	by Wright, Lawrence
Pseudodoxia Epidemica: Or, Enquiries into Very Many Received Tenentes, and Commonly Presumed Truths	by Browne, Thomas
Objections to Astrology	by Bok, Bart J.; Lawrence E. Jerome
The Myth of Repressed Memory: False Memories and Allegations of Sexual Abuse	by Loftus, Elizabeth; Katherine Ketcham
A Modest Proposal and Other Satires	by Swift, Jonathan
Memory Distortion: How Minds, Brains, and Societies Reconstruct the Past	by Schacter, Daniel L. (ed.)
Making Monsters: False Memories, Psychotherapy, and Sexual Hysteria	by Ofshe, Richard; Ethan Watters
The Little Black Book of Scams	by Australian Competition and Consumer Commission
Leviathan	by Hobbes, Thomas
Investigating the Unexplained	by Harris, Melvin
In Pursuit of Satan:The Police and the Occult	by Hicks, Robert D.
Humbug!: The Skeptic's Field Guide to Spotting Fallacies and Deceptive Arguments (Second Edition)	by Clark, Jef; Theo Clark
How Not to Test a Psychic: Ten Years of Remarkable Experiments With Renowned Clairvoyant Pavel Stepanek	by Gardner, Martin
How Mumbo-jumbo Conquered the World	by Wheen, Francis
Higher Superstition : The Academic Left and Its Quarrels With Science	by Gross, Paul; Norman Levitt
Has Science Found God? The Latest Results in the Search for Purpose in the Universe	by Stenger, Victor
Goddess Unmasked : The Rise of Neopagan Feminist Spirituality	by Davis, Philip G.
The Flight from Science and Reason	by Gross, Paul R.; Norman Levitt; Martin W. Lewis
Fear of Food : Environmentalist Scams, Media Mendacity, and the Law of Disparagement	by Arnold, Andrea
The Dose Makes the Poison: A Plain-Language Guide to Toxicology	by Ottoboni, Alice
Cosmos	by Sagan, Carl
Chemical Sensitivity : The Truth About Environmental Illness	by Barrett, Stephen; Ronald E. Gots
Bizarre Beliefs	by Hoggart, Simon; Mike Hutchinson
Big Bang: The Origin of the Universe	by Singh, Simon
The Best Australian Science Writing 2011	by Pincock, Stephen (ed.)
The Beginner's Guide to Winning the Nobel Prize	by Doherty, Peter
The Bear's Progress: SkeptoBear's World Tour 2004	by Bowditch, Peter
Bad Medicine : Misconceptions and Misuses Revealed, from Distance Healing to Vitamin O	by Wanjek, Christopher
Astrology Disproved	by Jerome, Lawrence E.
Astrology: What's Really in the Stars?	by Stewart, JV
The Age of Wonder : How the Romantic Generation Discovered the Beauty and Terror of Science	by Holmes, Richard
